
acetylengenerator = generatoracetylen
adressorts = ortsadress
adverbialsats = satsadverbial
adverser = verserad
åkerstubb = stubbåker
aktiebank = bankaktie
aktiebörs = börsaktie
aktiefond = fondaktie
aktieindex = indexaktie
aktivare = reaktiva
aktiverade = deaktivera
aktiverare = reaktivera
alban = banal
albas = basal
alkan = kanal
alkor = koral
alpen = penal
alpin = pinal
altan = analt
alternativutnyttjande = utnyttjandealternativ
alvers = versal
älvkung = kungälv
ambis = bisam
ambulansflyg = flygambulans
ambulanshelikopter = helikopterambulans
ammad = madam
amperemeter = meterampere
amtens = ensamt
analt = altan
analysprov = provanalys
analysresultat = resultatanalys
analysvåg = våganalys
analysvärde = värdeanalys
anar = aran
andedrag = dragande
andel = eland
andelen = lenande
anderöst = röstande
andesin = sinande
andetag = tagande
angör = göran
ankom = koman
ankor = koran
anläggningsindustri = industrianläggnings
anlag = lagan
anlopp = loppan
annonstext = textannons
anred = redan
ansar = arans
ansatsrör = röransats
anser = erans
ansett = ettans
anslag = lagans
anslog = slogan
anslut = lutans
anstorm = storman
ansträngt = trängtans
ansvar = varans
antagen = genanta
antåg = tågan
antal = talan
antennmast = mastantenn
antennreflektor = reflektorantenn
antennstav = stavantenn
antenntak = takantenn
antenntråd = trådantenn
antog = togan
anträd = trädan
använt = väntan
aran = anar
arans = ansar
aras = asar
arborr = borrar
arborrning = borrningar
aren = enar
argas = gasar
argast = gastar
arid = idar
arkformat = formatark
arkivfilm = filmarkiv
arkiv = kivar
arkli = kliar
arkont = kontar
arkräkning = kräkningar
arlöv = lövar
armen = menar
armkors = korsarm
armled = ledarm
armstöd = stödarm
arom = omar
arrak = rakar
arrendejord = jordarrende
arrester = resterar
årsbudget = budgetårs
arsel = selar
arsen = enars
arsen = senar
arsin = sinar
årsskott = skottårs
artegen = egenart
arten = tenar
ärtgul = gulärt
artonåring = tonåringar
arton = tonar
aryl = ylar
asar = aras
asbestträ = träasbest
asen = enas
aset = etas
asfaltväg = vägasfalt
asfull = fullas
åsgrus = grusås
askan = kanas
askas = kasas
askfaner = fanerask
askkartong = kartongask
aspar = paras
åsrygg = ryggås
assist = sistas
åstak = takås
asyl = ylas
ateljéfoto = fotoateljé
atlassiden = sidenatlas
attackflyg = flygattack
ätters = ersätt
automatkontroll = kontrollautomat
automatspel = spelautomat
automatsvarv = svarvautomat
automattelefon = telefonautomat
automattvätt = tvättautomat
avelsfisk = fiskavels
axelbas = basaxel
axelböjnings = böjningsaxel
axelfläns = flänsaxel
axelkam = kamaxel
axelkil = kilaxel
axelkopplings = kopplingsaxel
axellager = lageraxel
axellängd = längdaxel
axellång = långaxel
axelled = ledaxel
axelmotor = motoraxel
axelregulator = regulatoraxel
axelrör = röraxel
axelrotations = rotationsaxel
axelspärr = spärraxel
axelspår = spåraxel
axelspel = spelaxel
axelsprint = sprintaxel
axelstål = stålaxel
axelstöd = stödaxel
axelsvängnings = svängningsaxel
axeltapp = tappaxel
axeltryck = tryckaxel
axeltunnel = tunnelaxel
axelvibrations = vibrationsaxel
axelvinkel = vinkelaxel
backbroms = bromsback
bäckforell = forellbäck
backström = strömback
badbassäng = bassängbad
bäddsand = sandbädd
bäddsten = stenbädd
badkar = karbad
badsalt = saltbad
badstrand = strandbad
badvatten = vattenbad
bakteriegall = gallbakterie
balansbudget = budgetbalans
balanslinje = linjebalans
balansmaterial = materialbalans
balkbro = brobalk
balkjärn = järnbalk
balkplåt = plåtbalk
balktak = takbalk
ballastgrus = grusballast
ballastmakadam = makadamballast
ballonggas = gasballong
ballongspärr = spärrballong
balsamterpentin = terpentinbalsam
banal = alban
bandbroms = bromsband
bandfjäder = fjäderband
bandjärn = järnband
bandkant = kantband
bandkassett = kassettband
bandmått = måttband
bandskarv = skarvband
bandspärr = spärrband
bandstad = stadband
bandstål = stålband
bandtork = torkband
bandtraktor = traktorband
bandtransportör = transportörband
bandtransport = transportband
bandvåg = vågband
bandvinkel = vinkelband
bankaktie = aktiebank
bankclearing = clearingbank
bankfilial = filialbank
bankfiske = fiskebank
bänkfönster = fönsterbänk
bänkhyvel = hyvelbänk
bänknagel = nagelbänk
bänkskruv = skruvbänk
bänksvarv = svarvbänk
bantu = tuban
baren = enbar
bären = enbär
bärlager = lagerbär
barlast = lastbar
barlastvatten = vattenbarlast
barndag = dagbarn
barndaghems = daghemsbarn
barometerhöjd = höjdbarometer
barrens = rensbar
bärsen = enbärs
barsväng = svängbar
basal = albas
basaxel = axelbas
bashål = hålbas
bassängbad = badbassäng
bassängdamm = dammbassäng
bastu = tubas
båtfolk = folkbåt
båtförbindelse = förbindelsebåt
båthus = husbåt
båtlast = lastbåt
båtmotor = motorbåt
båtsegel = segelbåt
båtspel = spelbåt
batteritillsats = tillsatsbatteri
båttur = turbåt
bearbetningsdata = databearbetnings
benfisk = fiskben
benmärg = märgben
bensinmotor = motorbensin
bergek = ekberg
bergis = isberg
bergkalk = kalkberg
bergras = rasberg
bergsjö = sjöberg
bero = robe
betajärn = järnbeta
bete = tebe
betongfundament = fundamentbetong
betongjärn = järnbetong
betongmakadam = makadambetong
betongstamp = stampbetong
betongtegel = tegelbetong
betselstång = stångbetsel
biffstek = stekbiff
bilade = debila
bildnegativ = negativbild
bildraster = rasterbild
bildreportage = reportagebild
bildsignal = signalbild
bildskärm = skärmbild
bildskrift = skriftbild
bilfirma = firmabil
bilkran = kranbil
billast = lastbil
bilplog = plogbil
bilradio = radiobil
bilrally = rallybil
bilservice = servicebil
bilsjuk = sjukbil
bilskrot = skrotbil
bilsport = sportbil
bilstart = startbil
biltrafik = trafikbil
biltransport = transportbil
bisam = ambis
bitsocker = sockerbit
björkfaner = fanerbjörk
bjuder = erbjud
bladfil = filblad
bladfjäder = fjäderblad
bladfot = fotblad
bladglimmer = glimmerblad
bladgrodd = groddblad
bladguld = guldblad
bladrak = rakblad
bladrot = rotblad
bladsilver = silverblad
blågrön = grönblå
blåljus = ljusblå
blandningsmaskin = maskinblandnings
blanksilver = silverblank
blankvatten = vattenblank
blåsaren = renblåsa
blåsta = tablås
blästersand = sandbläster
blåsvart = svartblå
blekerifilter = filterblekeri
blekgrön = grönblek
blekgul = gulblek
blinkljus = ljusblink
blixtljus = ljusblixt
blockfot = fotblock
blocklager = lagerblock
blocklås = låsblock
blocklava = lavablock
blocklinje = linjeblock
blocksåg = sågblock
blocksats = satsblock
blodfull = fullblod
blodighet = hetblodig
blyglans = glansbly
blyslagg = slaggbly
blyspröjs = spröjsbly
blytetraetyl = tetraetylbly
blytetrametyl = tetrametylbly
bockbro = brobock
bockprov = provbock
boen = enbo
bogen = genbo
böjningsaxel = axelböjnings
bokhandels = handelsbok
bokkonst = konstbok
boklager = lagerbok
bokmål = målbok
böldpest = pestböld
bombflyg = flygbomb
bombsplitter = splitterbomb
bomkran = kranbom
bomlås = låsbom
bomsadel = sadelbom
bomskott = skottbom
bomstopp = stoppbom
bonga = gabon
bordhyvel = hyvelbord
bordhyvelmaskin = hyvelmaskinbord
bordpress = pressbord
bordsåg = sågbord
borrar = arborr
borrchuck = chuckborr
borrmaskin = maskinborr
borrmejsel = mejselborr
borrmotor = motorborr
borrningar = arborrning
borrskär = skärborr
borrspets = spetsborr
borrspindel = spindelborr
borrspiral = spiralborr
borrstål = stålborr
borrstol = stolborr
borrsväng = svängborr
borrtapp = tappborr
borrtryck = tryckborr
borrvagn = vagnborr
borrvev = vevborr
borrvinkel = vinkelborr
börsaktie = aktiebörs
bostads = stadsbo
bottencylinder = cylinderbotten
bottenform = formbotten
bottenkanal = kanalbotten
bottenkolonn = kolonnbotten
bottenlager = lagerbotten
bottenlös = lösbotten
bottensikt = siktbotten
bottensil = silbotten
bottenslam = slambotten
bottensten = stenbotten
bottentorv = torvbotten
brandkatastrof = katastrofbrand
bränneripotatis = potatisbränneri
bränslegas = gasbränsle
bränsleindustri = industribränsle
bränslekross = krossbränsle
brasa = sabra
brättmodell = modellbrätt
breddmall = mallbredd
breddsteg = stegbredd
brevkort = kortbrev
brevpost = postbrev
brobalk = balkbro
brobock = bockbro
broderimaskin = maskinbroderi
broderparti = partibroder
broförbindelse = förbindelsebro
brokabel = kabelbro
brokadsiden = sidenbrokad
broklaff = klaffbro
brokran = kranbro
brometylen = metylenbro
bromidjärn = järnbromid
bromidkalcium = kalciumbromid
bromidkalium = kaliumbromid
bromidmagnesium = magnesiumbromid
bromidnatrium = natriumbromid
bromsback = backbroms
bromsband = bandbroms
bromscylinder = cylinderbroms
bromsdifferential = differentialbroms
bromshjul = hjulbroms
bromskloss = klossbroms
bromsklots = klotsbroms
bromskon = konbroms
bromskraft = kraftbroms
bromslamell = lamellbroms
bromsmagnet = magnetbroms
bromsmotor = motorbroms
bromsnav = navbroms
bromspropeller = propellerbroms
bromsservo = servobroms
bromssko = skobroms
bromsskruv = skruvbroms
bromsspak = spakbroms
bromsspärr = spärrbroms
bromsspår = spårbroms
bromsstång = stångbroms
bromstråd = trådbroms
bromsvagn = vagnbroms
bronslager = lagerbrons
bronsmynt = myntbrons
bronsvira = virabrons
broponton = pontonbro
brosken = skenbro
bröstmur = murbröst
brostock = stockbro
brotschmaskin = maskinbrotsch
brottmål = målbrott
brovalv = valvbro
brungul = gulbrun
brunockra = ockrabrun
brunröd = rödbrun
brunrost = rostbrun
brusresistans = resistansbrus
brytreläsignal = signalbrytrelä
budgetårs = årsbudget
budgetbalans = balansbudget
budgetram = rambudget
buffertfjäder = fjäderbuffert
buffertgummi = gummibuffert
buljongkött = köttbuljong
bultfog = fogbult
bulthål = hålbult
bultjärn = järnbult
bultlås = låsbult
bultmutter = mutterbult
bultsax = saxbult
bultskruv = skruvbult
bultsprint = sprintbult
bultstål = stålbult
bunkerkol = kolbunker
burfågel = fågelbur
burhöns = hönsbur
burköl = ölburk
buse = sebu
bussled = ledbuss
busslinje = linjebuss
busstur = turbuss
buteljöl = ölbutelj
bygelkontakt = kontaktbygel
bygellås = låsbygel
bygelsåg = sågbygel
cellfilter = filtercell
cellulosafoder = fodercellulosa
cellulosanitrat = nitratcellulosa
cellulosaved = vedcellulosa
cementfärg = färgcement
cementsäck = säckcement
cementslagg = slaggcement
cementstål = stålcement
centraliserade = decentralisera
centralkraft = kraftcentral
centralradio = radiocentral
centralvärme = värmecentral
centrifugtork = torkcentrifug
centrumtapp = tappcentrum
centrumtrafik = trafikcentrum
charmat = matchar
chiffrerade = dechiffrera
chockpris = prischock
chuckborr = borrchuck
chucksvarv = svarvchuck
cigarettfilter = filtercigarett
cirkulationsluft = luftcirkulations
clearingbank = bankclearing
clearingvaluta = valutaclearing
crosscykel = cykelcross
cykelcross = crosscykel
cykelergometer = ergometercykel
cylinderbotten = bottencylinder
cylinderbroms = bromscylinder
cylinderfals = falscylinder
cylinderform = formcylinder
cylinderhuvud = huvudcylinder
cylinderlås = låscylinder
cylinderpress = presscylinder
cylindertopp = toppcylinder
cylindertork = torkcylinder
däckdubb = dubbdäck
dagbarn = barndag
daghemsbarn = barndaghems
dagis = isdag
dagman = mandag
dagmars = marsdag
dagsgammal = gammaldags
dagskott = skottdag
dagvård = vårddag
dalin = indal
dalmyr = myrdal
dammbassäng = bassängdamm
dammkrön = kröndamm
dammnål = nåldamm
dammväg = vägdamm
dankar = kardan
danse = sedan
danska = skadan
danspar = pardans
databearbetnings = bearbetningsdata
datadrift = driftdata
datafält = fältdata
datamaskin = maskindata
dator = ordat
datorspel = speldator
datumstämpel = stämpeldatum
deaktivera = aktiverade
debila = bilade
debutfilm = filmdebut
decentralisera = centraliserade
dechiffrera = chiffrerade
deflorera = florerade
deformera = formerade
degenerera = genererade
degradera = graderade
degummera = gummerade
dehumanisera = humaniserade
dehydratisera = hydratiserade
dehydrera = hydrerade
deja = jade
dejonisera = joniserade
dekarbonisera = karboniserade
deklarera = klarerade
deklassera = klasserade
deklorera = klorerade
dekontaminera = kontaminerade
dekryptera = krypterade
dela = lade
delaminera = laminerade
delegera = legerade
delfin = findel
delta = tadel
demagnetisera = magnetiserade
demaskera = maskerade
dematerialisera = materialiserade
demilitarisera = militariserade
demissionera = missionerade
demobilisera = mobiliserade
demodulera = modulerade
demo = mode
demontera = monterade
demoralisera = moraliserade
denationalisera = nationaliserade
denaturalisera = naturaliserade
denitrera = nitrerade
denotera = noterade
depilera = pilerade
deplacera = placerade
depolarisera = polariserade
deponera = ponerade
derangera = rangerade
desegregera = segregerade
desensibilisera = sensibiliserade
designa = signade
designera = signerade
destabilisera = stabiliserade
desulfurera = sulfurerade
detektorrör = rördetektor
diafragmapump = pumpdiafragma
diamantsvarv = svarvdiamant
diametergräns = gränsdiameter
differenskalkyl = kalkyldifferens
differenstryck = tryckdifferens
differentialbroms = bromsdifferential
digel = eldig
digre = redig
diskon = kondis
djupfräs = fräsdjup
djupplog = plogdjup
djuprot = rotdjup
djupvatten = vattendjup
djurexperiment = experimentdjur
djurfabel = fabeldjur
djurfarm = farmdjur
djurliv = livdjur
djurstam = stamdjur
domför = fördom
donläge = lägedon
dornpress = pressdorn
dörrflygel = flygeldörr
dörrpanel = paneldörr
dörrspegel = spegeldörr
dörrvalv = valvdörr
dotterson = sondotter
dragande = andedrag
dragkors = korsdrag
dragsåg = sågdrag
dragtryck = tryckdrag
dräkten = endräkt
drevkugg = kuggdrev
driftdata = datadrift
driftfrekvens = frekvensdrift
driftmaskin = maskindrift
driftmotor = motordrift
driftprov = provdrift
driftvatten = vattendrift
drivväxel = växeldriv
drömmar = mardröm
dubbdäck = däckdubb
dubbelfyr = fyrdubbel
dubblare = redubbla
dubblös = lösdubb
dubbrör = rördubb
dubbsvarv = svarvdubb
dynsand = sanddyn
dytorv = torvdy
effektkoefficient = koefficienteffekt
effektkomponent = komponenteffekt
effektreaktor = reaktoreffekt
effektrör = röreffekt
effekttransformator = transformatoreffekt
egenart = artegen
ekberg = bergek
ekerhjul = hjuleker
ekertråd = trådeker
ekkärl = kärlek
ekoradio = radioeko
ekvivalentnät = nätekvivalent
eland = andel
eldig = digel
eldsignal = signaleld
eldstorm = stormeld
elektrodkol = kolelektrod
elektrodmetall = metallelektrod
elektrodspets = spetselektrod
elektronikindustri = industrielektronik
elevatorkätting = kättingelevator
elevatorpråm = pråmelevator
elevatorrem = remelevator
elspis = spisel
emaljplåt = plåtemalj
emaljskylt = skyltemalj
emballageglas = glasemballage
enar = aren
enars = arsen
enas = asen
enbar = baren
enbär = bären
enbärs = bärsen
enbo = boen
endräkt = dräkten
energitröskel = tröskelenergi
enfas = fasen
engrad = graden
enharmonik = harmoniken
enhets = hetsen
enkel = kelen
enkelt = kelten
enklang = klangen
enklaver = klaveren
enklav = klaven
enköping = köpingen
enkristall = kristallen
enorm = ormen
enrådighet = rådigheten
enris = risen
ensak = saken
ensam = samen
ensamt = amtens
ensfyr = fyrens
enskikt = skikten
enskilt = kiltens
enskog = skogen
enslig = sligen
ental = talen
envärd = värden
enved = veden
envishet = visheten
envis = visen
erans = anser
erbjud = bjuder
ergometercykel = cykelergometer
erhåll = håller
erkänn = känner
ersätt = ätters
ersätt = sätter
ersmark = markers
esterharts = hartsester
estersyra = syraester
etagetork = torketage
etas = aset
etos = oset
etrusk = rusket
etslut = slutet
ettans = ansett
etthundra = hundraett
etyl = ylet
exil = ilex
experimentdjur = djurexperiment
experimentfält = fältexperiment
exportindustri = industriexport
exportprojekt = projektexport
exportsmör = smörexport
fabeldjur = djurfabel
fågelbur = burfågel
fågelsång = sångfågel
fågelsjö = sjöfågel
fågelsträck = sträckfågel
fakturakredit = kreditfaktura
falkjakt = jaktfalk
fallvatten = vattenfall
falscylinder = cylinderfals
falstratt = trattfals
fältdata = datafält
fältexperiment = experimentfält
fältmagnet = magnetfält
fältprov = provfält
fältslag = slagfält
fältväxel = växelfält
fältvektor = vektorfält
famnved = vedfamn
fanerask = askfaner
fanerbjörk = björkfaner
fanersvarv = svarvfaner
färdigslag = slagfärdig
färgcement = cementfärg
färgglans = glansfärg
färgkontrast = kontrastfärg
färgkyp = kypfärg
färglack = lackfärg
färgpasta = pastafärg
färgretusch = retuschfärg
färgsignal = signalfärg
färgspackel = spackelfärg
färgton = tonfärg
färgträ = träfärg
färgtryck = tryckfärg
färgtub = tubfärg
färgväxt = växtfärg
farmdjur = djurfarm
farmor = morfar
fårull = ullfår
fasadtegel = tegelfasad
fasen = enfas
faslik = likfas
fasplan = planfas
fasström = strömfas
fastland = landfast
fatöl = ölfat
felfrekvens = frekvensfel
felmanöver = manöverfel
felsignal = signalfel
felström = strömfel
felsyn = synfel
feltolerans = toleransfel
feltryck = tryckfel
feltyp = typfel
femmor = morfem
festglädje = glädjefest
fettlager = lagerfett
fettull = ullfett
fiberfilament = filamentfiber
fibermjöl = mjölfiber
fibertorv = torvfiber
fiberväxt = växtfiber
fikonkaktus = kaktusfikon
filamentfiber = fiberfilament
filblad = bladfil
filialbank = bankfilial
filmarkiv = arkivfilm
filmaskin = maskinfil
filmdebut = debutfilm
filmkomedi = komedifilm
filmlim = limfilm
filmsuccé = succéfilm
filmvatten = vattenfilm
filstål = stålfil
filterblekeri = blekerifilter
filtercell = cellfilter
filtercigarett = cigarettfilter
filtergrus = grusfilter
filterkol = kolfilter
filtermassa = massafilter
filterpress = pressfilter
filtersäck = säckfilter
filtersand = sandfilter
filterslang = slangfilter
filtertvätt = tvättfilter
filtertyg = tygfilter
filthår = hårfilt
filthatt = hattfilt
filtmaskin = maskinfilt
filtpress = pressfilt
filttak = takfilt
filttopp = toppfilt
findel = delfin
fingerring = ringfinger
finmjöl = mjölfin
fiolharts = hartsfiol
firmabil = bilfirma
fiskavels = avelsfisk
fiskben = benfisk
fiskebank = bankfiske
fiskegarn = garnfiske
fiskeindustri = industrifiske
fiskfjäll = fjällfisk
fiskindustri = industrifisk
fiskkniv = knivfisk
fiskstim = stimfisk
fjäderband = bandfjäder
fjäderblad = bladfjäder
fjäderbuffert = buffertfjäder
fjädergaffel = gaffelfjäder
fjäderharv = harvfjäder
fjäderkil = kilfjäder
fjäderkontakt = kontaktfjäder
fjäderlås = låsfjäder
fjäderregel = regelfjäder
fjäderregulator = regulatorfjäder
fjäderring = ringfjäder
fjäderskruv = skruvfjäder
fjäderspiral = spiralfjäder
fjäderstål = stålfjäder
fjäderstopp = stoppfjäder
fjädertryck = tryckfjäder
fjädervagn = vagnfjäder
fjäderventil = ventilfjäder
fjällfisk = fiskfjäll
fjällgrafit = grafitfjäll
fjällhög = högfjäll
fläcksådd = såddfläck
fläcksot = sotfläck
fläckvatten = vattenfläck
fläkttork = torkfläkt
fläkttransport = transportfläkt
flakvagn = vagnflak
flänsaxel = axelfläns
flänslager = lagerfläns
flänslös = lösfläns
flänsring = ringfläns
flänsrör = rörfläns
fläskstek = stekfläsk
flockylle = ylleflock
flodljus = ljusflod
florerade = deflorera
flötsmalm = malmflöts
flottering = ringflotte
flussglas = glasfluss
flygambulans = ambulansflyg
flygattack = attackflyg
flygbomb = bombflyg
flygeldörr = dörrflygel
flygfrakt = fraktflyg
flyglinje = linjeflyg
flygmotor = motorflyg
flygplatstrafik = trafikflygplats
flygpost = postflyg
flygsport = sportflyg
flygtaxi = taxiflyg
flygtrafik = trafikflyg
flygtransport = transportflyg
flyktingkvot = kvotflykting
flyktplan = planflykt
fockstag = stagfock
fodercellulosa = cellulosafoder
fodersatin = satinfoder
fodersilo = silofoder
foderskinn = skinnfoder
fodertyg = tygfoder
fodralläder = läderfodral
fogbult = bultfog
fogkant = kantfog
foglängd = längdfog
fogsvets = svetsfog
fogtapp = tappfog
fogvinkel = vinkelfog
folielaminat = laminatfolie
folkbåt = båtfolk
folkkultur = kulturfolk
folklek = lekfolk
folkparti = partifolk
folkteater = teaterfolk
fondaktie = aktiefond
fondkapital = kapitalfond
fönsterbänk = bänkfönster
fönstergaller = gallerfönster
fönsterglas = glasfönster
fönsterglugg = gluggfönster
fönsterram = ramfönster
förbindelsebåt = båtförbindelse
förbindelsebro = broförbindelse
förbindelsekabel = kabelförbindelse
förbindelsekanal = kanalförbindelse
förbindelserör = rörförbindelse
förbindelsespår = spårförbindelse
förbindelsetrafik = trafikförbindelse
förbindelseväg = vägförbindelse
fördom = domför
fördom = omförd
forellbäck = bäckforell
föremål = målföre
förespå = påföres
företagsam = samföretag
förhållandetal = talförhållande
förlag = lagför
förlustmarginal = marginalförlust
förlustresistans = resistansförlust
förlustvärme = värmeförlust
formatark = arkformat
formatsats = satsformat
formbotten = bottenform
formcylinder = cylinderform
formerade = deformera
formerare = reformera
forminsats = insatsform
formjärn = järnform
formler = lerform
formlös = lösform
formord = ordform
formpapp = pappform
formpress = pressform
formpuder = puderform
formsand = sandform
formspråk = språkform
formstans = stansform
formtegel = tegelform
formtopp = toppform
formvals = valsform
formvalv = valvform
föröver = överför
förpackningspapp = pappförpacknings
förslag = lagförs
förslut = slutför
försöksort = sortförsök
förtal = talför
fortepiano = pianoforte
förutan = utanför
förut = utför
förvar = varför
fotblad = bladfot
fotblock = blockfot
fotlager = lagerfot
fotoateljé = ateljéfoto
fotogenmotor = motorfotogen
fotsid = sidfot
fotstöd = stödfot
fotvalv = valvfot
fraktflyg = flygfrakt
fraktil = ilfrakt
framställaren = renframställa
fräsdjup = djupfräs
fräsprofil = profilfräs
frässats = satsfräs
frässchablon = schablonfräs
frässkruv = skruvfräs
frästand = tandfräs
frästorv = torvfräs
fräsvals = valsfräs
frekvensdrift = driftfrekvens
frekvensfel = felfrekvens
frekvensgräns = gränsfrekvens
frekvensnormal = normalfrekvens
friharts = hartsfri
fristen = stenfri
frittgrund = grundfritt
frökontroll = kontrollfrö
frostnatt = nattfrost
frustats = statsfru
fullas = asfull
fullblod = blodfull
fundamentbetong = betongfundament
fundamentmur = murfundament
fyrdubbel = dubbelfyr
fyrens = ensfyr
fyrlins = linsfyr
fyrsektor = sektorfyr
gabon = bonga
gaffelfjäder = fjädergaffel
gaffeltruck = truckgaffel
gala = laga
galan = langa
gallbakterie = bakteriegall
gallerfönster = fönstergaller
gallerspärr = spärrgaller
gammaldags = dagsgammal
gångkors = korsgång
gångkvarts = kvartsgång
gångled = ledgång
gångsport = portgångs
gångstol = stolgång
gångtunnel = tunnelgång
garantipris = prisgaranti
gardintyll = tyllgardin
garnfiske = fiskegarn
gasar = argas
gasa = saga
gasballong = ballonggas
gasbränsle = bränslegas
gasgenerator = generatorgas
gasindustri = industrigas
gaskoks = koksgas
gaskol = kolgas
gasrest = restgas
gassa = sagas
gastag = taggas
gastar = argast
gasta = staga
gasta = tagas
gästnatt = nattgäst
gastryck = tryckgas
gasugns = ugnsgas
gasvatten = vattengas
gatan = tanga
gata = taga
gavelhus = husgavel
gavelspets = spetsgavel
genanta = antagen
genbo = bogen
generatoracetylen = acetylengenerator
generatorgas = gasgenerator
genererade = degenerera
genin = ingen
gensvar = vargens
gentalan = talangen
genta = tagen
genväg = väggen
giftorm = ormgift
giftpil = pilgift
gjuterijärn = järngjuteri
gjuterisand = sandgjuteri
glaciärnisch = nischglaciär
glädjefest = festglädje
gladspel = spelglad
glansbly = blyglans
glansfärg = färgglans
glansmetall = metallglans
glasemballage = emballageglas
glasfluss = flussglas
glasfönster = fönsterglas
glashård = hårdglas
glasklar = klarglas
glaskonst = konstglas
glaskross = krossglas
glasreflektor = reflektorglas
glasservis = servisglas
glastak = takglas
glastråd = trådglas
glasvals = valsglas
glättkalander = kalanderglätt
glättmaskin = maskinglätt
glättplåt = plåtglätt
glimmerblad = bladglimmer
glödröd = rödglöd
glödvit = vitglöd
gluggfönster = fönsterglugg
gnejsgranit = granitgnejs
godstransport = transportgods
golvsten = stengolv
golvtegel = tegelgolv
göran = angör
gosa = sago
götjärn = järngöt
götmetall = metallgöt
götstål = stålgöt
graden = engrad
graderade = degradera
gradtecken = teckengrad
grafitfjäll = fjällgrafit
grågrön = gröngrå
gråjärn = järngrå
gråkall = kallgrå
granhäck = häckgran
granitgnejs = gnejsgranit
granitporfyr = porfyrgranit
gränsdiameter = diametergräns
gränsfrekvens = frekvensgräns
gränsland = landgräns
gränspris = prisgräns
gränssyn = syngräns
gränsträd = trädgräns
gränstull = tullgräns
gränszon = zongräns
gräsgrön = gröngräs
gråsvart = svartgrå
gravhög = höggrav
gråvit = vitgrå
gravörstans = stansgravör
grensla = lagrens
grillspett = spettgrill
groddblad = bladgrodd
grönblå = blågrön
grönblek = blekgrön
gröngrå = grågrön
gröngräs = gräsgrön
gröngul = gulgrön
grönskiffer = skiffergrön
grundfritt = frittgrund
grundmur = murgrund
grundplåt = plåtgrund
grundpremie = premiegrund
grundsten = stengrund
grundvattentryck = tryckgrundvatten
grupphus = husgrupp
gruppintresse = intressegrupp
gruppteater = teatergrupp
gruppterapi = terapigrupp
grusås = åsgrus
grusballast = ballastgrus
grusfilter = filtergrus
grusväg = väggrus
gulärt = ärtgul
gulblek = blekgul
gulbrun = brungul
guldblad = bladguld
guldmynt = myntguld
guldtand = tandguld
guldtråd = trådguld
gulgrön = gröngul
gulockra = ockragul
gulröd = rödgul
gulvit = vitgul
gummerade = degummera
gummibuffert = buffertgummi
gummiindustri = industrigummi
gummipedal = pedalgummi
gummiplantage = plantagegummi
gummiprofil = profilgummi
gummiskrot = skrotgummi
gummistämpel = stämpelgummi
gummisvamp = svampgummi
gummivals = valsgummi
guskpress = pressgusk
gyrohorisont = horisontgyro
hackarens = renshacka
häckgran = granhäck
haja = jaha
hålbas = bashål
hålbult = bulthål
håller = erhåll
halmtak = takhalm
hålprofil = profilhål
hålrot = rothål
halslager = lagerhals
hålslag = slaghål
hålsöm = sömhål
hålstamp = stamphål
hamnsluss = slusshamn
handelsbok = bokhandels
handom = omhand
hårdglas = glashård
härdstål = stålhärd
hårfilt = filthår
hårlös = löshår
harmoniken = enharmonik
harpunkanon = kanonharpun
hartsester = esterharts
hartsfiol = fiolharts
hartsfri = friharts
hartssyra = syraharts
hårull = ullhår
harvfjäder = fjäderharv
haspelmaskin = maskinhaspel
hästskjuts = skjutshäst
hästspann = spannhäst
hattfilt = filthatt
hattsvamp = svamphatt
havsis = ishavs
helikopterambulans = ambulanshelikopter
hemvård = vårdhem
hetblodig = blodighet
hetsen = enhets
hetsöm = ömhets
hihihi = hihihi
hihihi = hihihi
hissvagn = vagnhiss
hjulbroms = bromshjul
hjuleker = ekerhjul
hjulkugg = kugghjul
hjullavett = lavetthjul
hjulpress = presshjul
hjulsats = satshjul
hjulskovel = skovelhjul
hjulsvarv = svarvhjul
hjulväxel = växelhjul
högfjäll = fjällhög
höggrav = gravhög
höjdbarometer = barometerhöjd
höjdhopp = hopphöjd
hönsbur = burhöns
hopphöjd = höjdhopp
hopplängd = längdhopp
hoppstav = stavhopp
horisontgyro = gyrohorisont
horisontplan = planhorisont
hornsignal = signalhorn
hornspets = spetshorn
hornstäd = städhorn
hornstöt = stöthorn
huggaren = renhugga
huggkniv = knivhugg
humaniserade = dehumanisera
hundraett = etthundra
hundras = rashund
hundvakt = vakthund
husbåt = båthus
husgavel = gavelhus
husgrupp = grupphus
hushållsam = samhushåll
huskabel = kabelhus
husrad = radhus
hustimmer = timmerhus
husvagns = vagnshus
husvagn = vagnhus
huvudcylinder = cylinderhuvud
huvudkontakt = kontakthuvud
huvudled = ledhuvud
huvudsignal = signalhuvud
huvudskär = skärhuvud
huvudskruv = skruvhuvud
huvudspindel = spindelhuvud
huvudton = tonhuvud
huvudtyp = typhuvud
hydratiserade = dehydratisera
hydrerade = dehydrera
hyvelbänk = bänkhyvel
hyvelbord = bordhyvel
hyvelkutter = kutterhyvel
hyvelmaskinbord = bordhyvelmaskin
hyvelspån = spånhyvel
hyveltand = tandhyvel
idar = arid
igenom = omigen
ihågkom = komihåg
ilex = exil
ilfrakt = fraktil
impedanssystem = systemimpedans
impulsköp = köpimpuls
impulsljud = ljudimpuls
impulsström = strömimpuls
impulstid = tidimpuls
indal = dalin
indexaktie = aktieindex
induktorvev = vevinduktor
industrianläggnings = anläggningsindustri
industribränsle = bränsleindustri
industrielektronik = elektronikindustri
industriexport = exportindustri
industrifiske = fiskeindustri
industrifisk = fiskindustri
industrigas = gasindustri
industrigummi = gummiindustri
industrirobot = robotindustri
industrirör = rörindustri
ingen = genin
inkan = kanin
inkoka = kokain
insatsform = forminsats
insatskapital = kapitalinsats
insatsskär = skärinsats
inser = serin
instrumentpanel = panelinstrument
inte = tein
intressegrupp = gruppintresse
inval = valin
investerare = reinvestera
isberg = bergis
isdag = dagis
ishavs = havsis
iskristall = kristallis
island = landis
isnot = notis
jade = deja
jaha = haja
jako = koja
jaktfalk = falkjakt
jaktlicens = licensjakt
järnbalk = balkjärn
järnband = bandjärn
järnbeta = betajärn
järnbetong = betongjärn
järnbromid = bromidjärn
järnbult = bultjärn
järnform = formjärn
järngjuteri = gjuterijärn
järngöt = götjärn
järngrå = gråjärn
järnkisel = kiseljärn
järnkors = korsjärn
järnkrok = krokjärn
järnlist = listjärn
järnmangan = manganjärn
järnnit = nitjärn
järnplåt = plåtjärn
järnram = ramjärn
järnring = ringjärn
järnrör = rörjärn
järnrost = rostjärn
järnsko = skojärn
järnskrot = skrotjärn
järnslagg = slaggjärn
järnspant = spantjärn
järnspik = spikjärn
järnstämpel = stämpeljärn
järnstång = stångjärn
järnsvarv = svarvjärn
järntråd = trådjärn
järnverk = verkjärn
järnvinkel = vinkeljärn
jaså = såja
jästkultur = kulturjäst
jästpress = pressjäst
java = vaja
joniserade = dejonisera
jordarrende = arrendejord
jourpräst = prästjour
jumperset = setjumper
jute = teju
kabelbro = brokabel
kabelförbindelse = förbindelsekabel
kabelhus = huskabel
kabelnät = nätkabel
kabelrör = rörkabel
kabelskarv = skarvkabel
kabelstativ = stativkabel
kabintryck = tryckkabin
kaffesurrogat = surrogatkaffe
käftkross = krosskäft
kajmur = murkaj
kajsten = stenkaj
kaktusfikon = fikonkaktus
kalanderglätt = glättkalander
kalandervals = valskalander
kalciumbromid = bromidkalcium
kaliumbromid = bromidkalium
kalkberg = bergkalk
kalkmärgel = märgelkalk
kalkputs = putskalk
kalkslam = slamkalk
kalkvatten = vattenkalk
kalkyldifferens = differenskalkyl
kalkylperiod = periodkalkyl
kalkylpris = priskalkyl
kallgrå = gråkall
kamaxel = axelkam
kamerastativ = stativkamera
kamnål = nålkam
kamsåg = sågkam
kamull = ullkam
kanal = alkan
kanalbotten = bottenkanal
kanalförbindelse = förbindelsekanal
kanalled = ledkanal
kanalsluss = slusskanal
kanaltork = torkkanal
kanaltrafik = trafikkanal
kanas = askan
kanin = inkan
känner = erkänn
kannors = norskan
kanonharpun = harpunkanon
kanonsalut = salutkanon
kanontorn = tornkanon
kantband = bandkant
kantfog = fogkant
kantstål = stålkant
kantsten = stenkant
kanttråd = trådkant
kantvals = valskant
kaparen = renkapa
kapitalfond = fondkapital
kapitalinsats = insatskapital
kapitalreserv = reservkapital
kapitalrörelse = rörelsekapital
kapved = vedkap
karaffvin = vinkaraff
karbad = badkar
karboniserade = dekarbonisera
kardan = dankar
käringskvaller = skvallerkäring
käringsladder = sladderkäring
karkas = kaskar
kärlek = ekkärl
karman = mankar
karmas = maskar
karmin = minkar
karmstol = stolkarm
karsil = silkar
karska = skakar
karskas = kaskars
kartan = tankar
kartellpris = priskartell
kartongask = askkartong
kartongmaskin = maskinkartong
kartongpapp = pappkartong
kartongpärm = pärmkartong
karvas = vaskar
karva = vakar
kasas = askas
kaskar = karkas
kaskars = karskas
kasko = kokas
kassapost = postkassa
kassareserv = reservkassa
kassettband = bandkassett
kassettvideo = videokassett
kastspjut = spjutkast
kastved = vedkast
kastvind = vindkast
katalogkort = kortkatalog
katastrofbrand = brandkatastrof
kättingelevator = elevatorkätting
kättinglänk = länkkätting
kättingstål = stålkätting
kattlo = lokatt
kattras = raskatt
kattuntryck = tryckkattun
kausring = ringkaus
kelen = enkel
kelten = enkelt
kelvin = vinkel
kikkran = krankik
kilaxel = axelkil
kilfjäder = fjäderkil
killås = låskil
kilring = ringkil
kilsöm = sömkil
kilspår = spårkil
kilstål = stålkil
kilsteg = stegkil
kilsten = stenkil
kiltens = enskilt
kiseljärn = järnkisel
kiselmangan = mangankisel
kittost = ostkitt
kittvax = vaxkitt
kivar = arkiv
klabbved = vedklabb
klaffbro = broklaff
klaffpump = pumpklaff
klaffventil = ventilklaff
klampved = vedklamp
klangen = enklang
klarerade = deklarera
klarglas = glasklar
klarvatten = vattenklar
klasserade = deklassera
klaven = enklav
klaveren = enklaver
kliar = arkli
klipparen = renklippa
klorerade = deklorera
klosettvatten = vattenklosett
klossbroms = bromskloss
klösta = taklös
klotsbroms = bromsklots
klyvved = vedklyv
knävinkel = vinkelknä
knivfisk = fiskkniv
knivhugg = huggkniv
knivkubb = kubbkniv
knivskaft = skaftkniv
knivstick = stickkniv
knölrot = rotknöl
knölstam = stamknöl
kodsignal = signalkod
kodspråk = språkkod
kodtelegram = telegramkod
koefficienteffekt = effektkoefficient
koja = jako
kokain = inkoka
kokas = kasko
koksgas = gaskoks
kokssats = satskoks
kolbunker = bunkerkol
kolelektrod = elektrodkol
kolfilter = filterkol
kolgas = gaskol
kolonnbotten = bottenkolonn
kolonnkromatografi = kromatografikolonn
kölplåt = plåtköl
kolskiffer = skifferkol
kolskikt = skiktkol
kolslam = slamkol
kolstybb = stybbkol
kolstycke = styckekol
kolvlös = löskolv
kolvmembran = membrankolv
kolvmotor = motorkolv
kolvpress = presskolv
kolvpump = pumpkolv
kolvtryck = tryckkolv
kolvventil = ventilkolv
koman = ankom
koman = manko
komedifilm = filmkomedi
komihåg = ihågkom
komjölk = mjölkko
kompanitross = trosskompani
komponenteffekt = effektkomponent
konbroms = bromskon
kondensatorrör = rörkondensator
kondensatortryck = tryckkondensator
kondis = diskon
konkavkonvex = konvexkonkav
konkross = krosskon
konkurrenspris = priskonkurrens
konservkött = köttkonserv
konsollager = lagerkonsol
konstbok = bokkonst
konstglas = glaskonst
kontaktbygel = bygelkontakt
kontaktfjäder = fjäderkontakt
kontakthuvud = huvudkontakt
kontaktpropp = proppkontakt
kontaktpunkt = punktkontakt
kontaktskruv = skruvkontakt
kontaktspets = spetskontakt
kontakttid = tidkontakt
kontakttryck = tryckkontakt
kontaktvinkel = vinkelkontakt
kontaminerade = dekontaminera
kontar = arkont
kontokredit = kreditkonto
kontoskuld = skuldkonto
kontrastfärg = färgkontrast
kontraströntgen = röntgenkontrast
kontrollautomat = automatkontroll
kontrollervals = valskontroller
kontrollfrö = frökontroll
kontrollmått = måttkontroll
kontrollpunkt = punktkontroll
kontrollregister = registerkontroll
kontrollsystem = systemkontroll
konverterstål = stålkonverter
konvexkonkav = konkavkonvex
koordinatplan = plankoordinat
köpimpuls = impulsköp
köpingen = enköping
kopparskrot = skrotkoppar
kopparstång = stångkoppar
koppelstång = stångkoppel
kopplingsaxel = axelkopplings
koral = alkor
koran = ankor
korgspån = spånkorg
korgvagn = vagnkorg
korgvaluta = valutakorg
korkskruv = skruvkork
kornkrut = krutkorn
kornmalt = maltkorn
kornsnö = snökorn
körprov = provkör
körsång = sångkör
korsarm = armkors
korsdrag = dragkors
korsgång = gångkors
korsjärn = järnkors
korsström = strömkors
korsväg = vägkors
kortbrev = brevkort
kortkatalog = katalogkort
kortregister = registerkort
kortspel = spelkort
kortstämpel = stämpelkort
korttelefon = telefonkort
korvars = varskor
korvmål = målkorv
köttbuljong = buljongkött
köttkonserv = konservkött
kraftbroms = bromskraft
kraftcentral = centralkraft
kraftmaskin = maskinkraft
kraftnatur = naturkraft
kraftprov = provkraft
kraftreserv = reservkraft
kraftsvets = svetskraft
kräkningar = arkräkning
kranbil = bilkran
kranbom = bomkran
kranbro = brokran
krankik = kikkran
kranlok = lokkran
kranlokomotiv = lokomotivkran
kranmagnet = magnetkran
kranmast = mastkran
kranskänk = skänkkran
krantapp = tappkran
krantruck = truckkran
kranvatten = vattenkran
kreditfaktura = fakturakredit
kreditkonto = kontokredit
kreditkund = kundkredit
kreditvaluta = valutakredit
kristallen = enkristall
kristallis = iskristall
kristalltvilling = tvillingkristall
krokjärn = järnkrok
krokskaft = skaftkrok
kromatografikolonn = kolonnkromatografi
kröndamm = dammkrön
krossbränsle = bränslekross
krossglas = glaskross
krosskäft = käftkross
krosskon = konkross
krossmaskin = maskinkross
krossprov = provkross
krossvals = valskross
krutkorn = kornkrut
krutraket = raketkrut
krypterade = dekryptera
kubbkniv = knivkubb
kubbved = vedkubb
kuggdrev = drevkugg
kugghjul = hjulkugg
kultperson = personkult
kulturfolk = folkkultur
kulturjäst = jästkultur
kundkredit = kreditkund
kungälv = älvkung
kupoltak = takkupol
kutterhyvel = hyvelkutter
kvarnsten = stenkvarn
kvarntratt = trattkvarn
kvarnvatten = vattenkvarn
kvarnvind = vindkvarn
kvartsgång = gångkvarts
kvotflykting = flyktingkvot
kypfärg = färgkyp
lackfärg = färglack
lackstång = stånglack
lacktråd = trådlack
lade = dela
läderfodral = fodralläder
läderrem = remläder
lädersko = skoläder
lädervals = valsläder
laga = gala
lagan = anlag
lagans = anslag
lägedon = donläge
lageraxel = axellager
lagerbär = bärlager
lagerblock = blocklager
lagerbok = boklager
lagerbotten = bottenlager
lagerbrons = bronslager
lagerfett = fettlager
lagerfläns = flänslager
lagerfot = fotlager
lagerhals = halslager
lagerkonsol = konsollager
lagerlängd = längdlager
lagerluft = luftlager
lagerram = ramlager
lagerreserv = reservlager
lagerring = ringlager
lagerskål = skållager
lagersköld = sköldlager
lagerspår = spårlager
lagerspets = spetslager
lagertapp = tapplager
lagertryck = trycklager
lagför = förlag
lagförs = förslag
lagliga = ligalag
lagras = raslag
lagrens = grensla
lalala = lalala
lalala = lalala
lamellbroms = bromslamell
lamellträ = trälamell
lami = mila
laminatfolie = folielaminat
laminerade = delaminera
lamor = morla
lampettspegel = spegellampett
landfast = fastland
landgräns = gränsland
landis = island
langa = galan
långaxel = axellång
längdaxel = axellängd
längdfog = foglängd
längdhopp = hopplängd
längdlager = lagerlängd
längdmeter = meterlängd
längdprov = provlängd
längdrörelse = rörelselängd
längdspår = spårlängd
länkkätting = kättinglänk
larmsiren = sirenlarm
larva = valar
låsblock = blocklås
låsbom = bomlås
låsbult = bultlås
låsbygel = bygellås
låscylinder = cylinderlås
låsfjäder = fjäderlås
laska = skala
låskil = killås
låsmutter = mutterlås
låsregel = regellås
lassa = salas
låsskruv = skruvlås
låsslid = slidlås
låssten = stenlås
lasta = talas
lastbar = barlast
lastbåt = båtlast
lastbil = billast
lastlinje = linjelast
lastpråm = pråmlast
lasttrafik = trafiklast
lastvagn = vagnlast
lastvikt = viktlast
lata = tala
lates = tesla
latta = talat
lavablock = blocklava
lavars = varsla
lava = vala
lavetthjul = hjullavett
lave = vela
ledarm = armled
ledaxel = axelled
ledbuss = bussled
ledgång = gångled
ledhuvud = huvudled
ledkanal = kanalled
ledningsvatten = vattenlednings
ledsegel = segelled
ledtång = tångled
ledvatten = vattenled
legerade = delegera
lekfolk = folklek
lekpark = parklek
lemmans = manslem
lenande = andelen
lente = telen
lerform = formler
leva = vale
leveransprov = provleverans
licensjakt = jaktlicens
liftstol = stollift
ligalag = lagliga
ligatur = turliga
likfas = faslik
limfilm = filmlim
limtång = tånglim
limträ = trälim
linjebalans = balanslinje
linjeblock = blocklinje
linjebuss = busslinje
linjeflyg = flyglinje
linjelast = lastlinje
linjemått = måttlinje
linjering = ringlinje
linjesprång = språnglinje
linjeström = strömlinje
linjesystem = systemlinje
linjetal = tallinje
linjetrafik = trafiklinje
linjetryck = trycklinje
linsfyr = fyrlins
listjärn = järnlist
listprofil = profillist
listträ = trälist
livdjur = djurliv
livmoder = moderliv
ljudimpuls = impulsljud
ljudsignal = signalljud
ljusblå = blåljus
ljusblink = blinkljus
ljusblixt = blixtljus
ljusflod = flodljus
ljusramp = rampljus
ljusreflex = reflexljus
ljusreklam = reklamljus
ljusröd = rödljus
ljussignal = signalljus
ljusvärme = värmeljus
lockskruv = skruvlock
lokalval = vallokal
lokatt = kattlo
lokkran = kranlok
lokomotivkran = kranlokomotiv
lokomotivmotor = motorlokomotiv
löksmak = smaklök
lönnsocker = sockerlönn
loos = oslo
löpeost = ostlöpe
loppan = anlopp
lösbotten = bottenlös
lösdubb = dubblös
lösfläns = flänslös
lösform = formlös
löshår = hårlös
löskolv = kolvlös
lösram = ramlös
lösskägg = skägglös
lössnö = snölös
lösvikt = viktlös
lövar = arlöv
luftcirkulations = cirkulationsluft
luftlager = lagerluft
luftsug = sugluft
lufttork = torkluft
lufttryck = tryckluft
lundmark = marklund
lusa = salu
lusta = talus
lustmord = mordlust
lutans = anslut
lyftventil = ventillyft
madam = ammad
magnesiumbromid = bromidmagnesium
magnetbroms = bromsmagnet
magnetfält = fältmagnet
magnetiserade = demagnetisera
magnetkran = kranmagnet
magnetspår = spårmagnet
magnetstång = stångmagnet
magnetstav = stavmagnet
makadamballast = ballastmakadam
makadambetong = betongmakadam
makadamväg = vägmakadam
målbok = bokmål
målbrott = brottmål
målföre = föremål
målkorv = korvmål
mallbredd = breddmall
malmflöts = flötsmalm
målpunkt = punktmål
målrobot = robotmål
måltids = tidsmål
maltkorn = kornmalt
mandag = dagman
manganjärn = järnmangan
mangankisel = kiselmangan
mängdstandard = standardmängd
mangelpress = pressmangel
mankar = karman
manko = koman
manöverfel = felmanöver
manöver = överman
manslem = lemmans
mantal = talman
mantelmur = murmantel
mantelplåt = plåtmantel
mantelprojektil = projektilmantel
mantelring = ringmantel
manteltråd = trådmantel
mardröm = drömmar
märgben = benmärg
märgelkalk = kalkmärgel
marginalförlust = förlustmarginal
marginalvinst = vinstmarginal
markers = ersmark
marklund = lundmark
marktäkt = täktmark
maror = ormar
marsdag = dagmars
maskar = karmas
maskerade = demaskera
maskinblandnings = blandningsmaskin
maskinborr = borrmaskin
maskinbroderi = broderimaskin
maskinbrotsch = brotschmaskin
maskindata = datamaskin
maskindrift = driftmaskin
maskinfil = filmaskin
maskinfilt = filtmaskin
maskinglätt = glättmaskin
maskinhaspel = haspelmaskin
maskinkartong = kartongmaskin
maskinkraft = kraftmaskin
maskinkross = krossmaskin
maskinpapp = pappmaskin
maskinpress = pressmaskin
maskinsådd = såddmaskin
maskinsåg = sågmaskin
maskinså = såmaskin
maskinskruv = skruvmaskin
maskinsöm = sömmaskin
maskinspinneri = spinnerimaskin
maskinstenografi = stenografimaskin
maskintorv = torvmaskin
maskintryck = tryckmaskin
maskintvätt = tvättmaskin
maskintyp = typmaskin
massafilter = filtermassa
massaprov = provmassa
massavals = valsmassa
massaved = vedmassa
masström = strömmas
mastantenn = antennmast
mastkran = kranmast
matchar = charmat
materialbalans = balansmaterial
materialiserade = dematerialisera
materialtransport = transportmaterial
matos = osmat
matrispapp = pappmatris
matrispress = pressmatris
måttband = bandmått
matte = temat
måttkontroll = kontrollmått
måttlinje = linjemått
måttstav = stavmått
måttstock = stockmått
måttstreck = streckmått
medeltillväxt = tillväxtmedel
mejerismör = smörmejeri
mejselborr = borrmejsel
mejselskaft = skaftmejsel
mejselspår = spårmejsel
membrankolv = kolvmembran
menar = armen
metallelektrod = elektrodmetall
metallglans = glansmetall
metallgöt = götmetall
metallpulver = pulvermetall
metallskrot = skrotmetall
metalltyp = typmetall
meterampere = amperemeter
meterlängd = längdmeter
metervåg = vågmeter
metylenbro = brometylen
mikrometerskruv = skruvmikrometer
mila = lami
militariserade = demilitarisera
miljörisk = riskmiljö
minkar = karmin
missionerade = demissionera
mjölfiber = fibermjöl
mjölfin = finmjöl
mjölkko = komjölk
mjölsikt = siktmjöl
möbelstil = stilmöbel
mobiliserade = demobilisera
mode = demo
modellbrätt = brättmodell
moderliv = livmoder
modulatorrör = rörmodulator
modulerade = demodulera
modulplan = planmodul
momentmotor = motormoment
mönsterpress = pressmönster
mönsterspår = spårmönster
monterade = demontera
moraliserade = demoralisera
mordlust = lustmord
morfar = farmor
morfem = femmor
morla = lamor
mosaiksten = stenmosaik
moster = termos
motoraxel = axelmotor
motorbåt = båtmotor
motorbensin = bensinmotor
motorborr = borrmotor
motorbroms = bromsmotor
motordrift = driftmotor
motorflyg = flygmotor
motorfotogen = fotogenmotor
motorkolv = kolvmotor
motorlokomotiv = lokomotivmotor
motormoment = momentmotor
motorpump = pumpmotor
motorram = rammotor
motorserie = seriemotor
motorsprit = spritmotor
motorställ = ställmotor
motorstart = startmotor
motortraktor = traktormotor
motståndslag = slagmotstånd
muffrör = rörmuff
murbröst = bröstmur
murfundament = fundamentmur
murgrund = grundmur
murkaj = kajmur
murmantel = mantelmur
mursten = stenmur
murtegel = tegelmur
musikprogram = programmusik
mutterbult = bultmutter
mutterlås = låsmutter
myntbrons = bronsmynt
myntguld = guldmynt
myntsilver = silvermynt
myrdal = dalmyr
myrtall = tallmyr
myrtorv = torvmyr
näbbsax = saxnäbb
nagelbänk = bänknagel
nåldamm = dammnål
nålkam = kamnål
nålspets = spetsnål
nålstick = sticknål
nålventil = ventilnål
nätekvivalent = ekvivalentnät
nationaliserade = denationalisera
nätkabel = kabelnät
natriumbromid = bromidnatrium
nätstängsel = stängselnät
nattfrost = frostnatt
nattgäst = gästnatt
nättopp = toppnät
nattvak = vaknatt
naturaliserade = denaturalisera
naturkraft = kraftnatur
nätväxel = växelnät
navbroms = bromsnav
negativbild = bildnegativ
neutronresonans = resonansneutron
nischglaciär = glaciärnisch
nitjärn = järnnit
nitratcellulosa = cellulosanitrat
nitrerade = denitrera
nitstål = stålnit
nockspel = spelnock
nockvinsch = vinschnock
nödrim = rimnöd
normalfrekvens = frekvensnormal
normaltid = tidnormal
norskan = kannors
noterade = denotera
notis = isnot
nummerordnings = ordningsnummer
nummerrevy = revynummer
nummerserie = serienummer
nyckelring = ringnyckel
objektivprisma = prismaobjektiv
ockrabrun = brunockra
ockragul = gulockra
ockraröd = rödockra
odlaren = renodla
offerrök = rökoffer
ökensand = sandöken
ölburk = burköl
ölbutelj = buteljöl
ölfat = fatöl
omar = arom
omförd = fördom
omhand = handom
ömhets = hetsöm
omigen = igenom
omsättningsväxel = växelomsättnings
ordat = dator
ordform = formord
ordningsam = samordning
ordningsnummer = nummerordnings
ordvits = vitsord
ormar = maror
ormen = enorm
ormgift = giftorm
orre = reor
orres = resor
orten = tenor
ortsadress = adressorts
orttak = takort
orttransport = transportort
orvar = varor
oscillatorrör = röroscillator
oset = etos
oslo = loos
osmat = matos
ostkitt = kittost
ostlöpe = löpeost
östöver = överöst
ostvassle = vassleost
överför = föröver
överman = manöver
överöst = östöver
påföres = förespå
paketpost = postpaket
pälssäl = sälpäls
paneldörr = dörrpanel
panelinstrument = instrumentpanel
paneltak = takpanel
panelvägg = väggpanel
pappform = formpapp
pappförpacknings = förpackningspapp
pappkartong = kartongpapp
pappmaskin = maskinpapp
pappmatris = matrispapp
papptak = takpapp
paras = aspar
pardans = danspar
parkettstav = stavparkett
parklek = lekpark
pärmkartong = kartongpärm
parrim = rimpar
partibroder = broderparti
partifolk = folkparti
partipress = pressparti
partistöd = stödparti
parvis = vispar
pastafärg = färgpasta
påvar = varpå
pedalgummi = gummipedal
penal = alpen
pendelpress = presspendel
pendelslag = slagpendel
pensionspremie = premiepensions
periodkalkyl = kalkylperiod
periodrapport = rapportperiod
personalvård = vårdpersonal
personkult = kultperson
pestböld = böldpest
pianoforte = fortepiano
pilerade = depilera
pilgift = giftpil
pinal = alpin
pintera = terapin
pinter = terpin
pipskänk = skänkpip
placerade = deplacera
planfas = fasplan
planflykt = flyktplan
planhorisont = horisontplan
plankoordinat = koordinatplan
planmodul = modulplan
planskikt = skiktplan
planslid = slidplan
planspegel = spegelplan
plansteg = stegplan
plansvets = svetsplan
plantagegummi = gummiplantage
planvåg = vågplan
plastsvamp = svampplast
plastväv = vävplast
plåtbalk = balkplåt
plåtemalj = emaljplåt
plåtglätt = glättplåt
plåtgrund = grundplåt
plåtjärn = järnplåt
plåtköl = kölplåt
plåtmantel = mantelplåt
plåtpress = pressplåt
plåtram = ramplåt
plåttak = takplåt
plogbil = bilplog
plogdjup = djupplog
plogsväng = svängplog
polariserade = depolarisera
polisradio = radiopolis
pölvatten = vattenpöl
polygontåg = tågpolygon
ponerade = deponera
pontonbro = broponton
porfyrgranit = granitporfyr
portgångs = gångsport
portvalv = valvport
postbrev = brevpost
postflyg = flygpost
postkassa = kassapost
postpaket = paketpost
posttrafik = trafikpost
potatisbränneri = bränneripotatis
potatisskal = skalpotatis
pråmelevator = elevatorpråm
pråmlast = lastpråm
prästjour = jourpräst
premiegrund = grundpremie
premiepensions = pensionspremie
premietariff = tariffpremie
pressbord = bordpress
presscylinder = cylinderpress
pressdorn = dornpress
pressfilter = filterpress
pressfilt = filtpress
pressform = formpress
pressgusk = guskpress
presshjul = hjulpress
pressjäst = jästpress
presskolv = kolvpress
pressmangel = mangelpress
pressmaskin = maskinpress
pressmatris = matrispress
pressmönster = mönsterpress
pressparti = partipress
presspendel = pendelpress
pressplåt = plåtpress
presspulver = pulverpress
pressram = rampress
presstegel = tegelpress
presstork = torkpress
presstorv = torvpress
presstryck = tryckpress
pressvals = valspress
pressvinkel = vinkelpress
prischock = chockpris
prisgaranti = garantipris
prisgräns = gränspris
priskalkyl = kalkylpris
priskartell = kartellpris
priskonkurrens = konkurrenspris
prismaobjektiv = objektivprisma
prismasvarv = svarvprisma
prisstandard = standardpris
produktstandard = standardprodukt
proffstennis = tennisproffs
profilfräs = fräsprofil
profilgummi = gummiprofil
profilhål = hålprofil
profillist = listprofil
profilstål = stålprofil
profilvinkel = vinkelprofil
programmusik = musikprogram
programstart = startprogram
programvärd = värdprogram
projektexport = exportprojekt
projektilmantel = mantelprojektil
propellerbroms = bromspropeller
propellertryck = tryckpropeller
propellerturbin = turbinpropeller
proppkontakt = kontaktpropp
provanalys = analysprov
provbock = bockprov
provdrift = driftprov
provfält = fältprov
provkör = körprov
provkraft = kraftprov
provkross = krossprov
provlängd = längdprov
provleverans = leveransprov
provmassa = massaprov
provslev = slevprov
provtråd = trådprov
provtryck = tryckprov
publikrekord = rekordpublik
puderform = formpuder
pulsradar = radarpuls
pulssynk = synkpuls
pulvermetall = metallpulver
pulverpress = presspulver
pumpdiafragma = diafragmapump
pumpklaff = klaffpump
pumpkolv = kolvpump
pumpmotor = motorpump
pumpskovel = skovelpump
punktkontakt = kontaktpunkt
punktkontroll = kontrollpunkt
punktmål = målpunkt
punktraster = rasterpunkt
punktsvets = svetspunkt
punkturspets = spetspunktur
putskalk = kalkputs
putsvägg = väggputs
radarpuls = pulsradar
radhus = husrad
rådigheten = enrådighet
radiobil = bilradio
radiocentral = centralradio
radioeko = ekoradio
radiopolis = polisradio
radsådd = såddrad
radså = sårad
radslut = slutrad
rakar = arrak
rakblad = bladrak
raketkrut = krutraket
raketsignal = signalraket
raketsteg = stegraket
rallybil = bilrally
rambudget = budgetram
ramfönster = fönsterram
ramjärn = järnram
ramlager = lagerram
ramlös = lösram
rammotor = motorram
ramplåt = plåtram
rampljus = ljusramp
rampress = pressram
ramrör = rörram
ramsåg = sågram
ramträ = träram
randsvets = svetsrand
rangerade = derangera
rapportperiod = periodrapport
rasberg = bergras
råsegel = segelrå
rashund = hundras
raskatt = kattras
raslag = lagras
rasptand = tandrasp
rasterbild = bildraster
rasterpunkt = punktraster
rävröd = rödräv
reaktiva = aktivare
reaktivera = aktiverare
reaktoreffekt = effektreaktor
redan = anred
redig = digre
redubbla = dubblare
reflektorantenn = antennreflektor
reflektorglas = glasreflektor
reflektorspegel = spegelreflektor
reflektorstav = stavreflektor
reflexljus = ljusreflex
reformera = formerare
regelfjäder = fjäderregel
regellås = låsregel
registerkontroll = kontrollregister
registerkort = kortregister
registerton = tonregister
regulatoraxel = axelregulator
regulatorfjäder = fjäderregulator
regulatorvikt = viktregulator
reinvestera = investerare
reklamljus = ljusreklam
reklamtext = textreklam
rekordpublik = publikrekord
rekordvärme = värmerekord
remelevator = elevatorrem
remläder = läderrem
renblåsa = blåsaren
renframställa = framställaren
renhugga = huggaren
renkapa = kaparen
renklippa = klipparen
renodla = odlaren
rensbar = barrens
renshacka = hackarens
renskära = skäraren
renskriva = skrivaren
renslipa = sliparen
reor = orre
reportagebild = bildreportage
reservkapital = kapitalreserv
reservkassa = kassareserv
reservkraft = kraftreserv
reservlager = lagerreserv
reservoartryck = tryckreservoar
resistansbrus = brusresistans
resistansförlust = förlustresistans
resmila = smilare
resonansneutron = neutronresonans
resor = orres
resta = stare
resterar = arrester
restgas = gasrest
resultatanalys = analysresultat
retortvagn = vagnretort
retuschfärg = färgretusch
revarna = varnare
reva = vare
revynummer = nummerrevy
rikttal = talrikt
rimnöd = nödrim
rimpar = parrim
ringfinger = fingerring
ringfjäder = fjäderring
ringfläns = flänsring
ringflotte = flottering
ringjärn = järnring
ringkaus = kausring
ringkil = kilring
ringlager = lagerring
ringlinje = linjering
ringmantel = mantelring
ringnyckel = nyckelring
ringrost = rostring
ringspår = spårring
ringtryck = tryckring
ringväg = vägring
ringvält = vältring
ringvalv = valvring
ringvulst = vulstring
risen = enris
riskmiljö = miljörisk
risksumma = summarisk
robe = bero
robotindustri = industrirobot
robotmål = målrobot
rockskört = skörtrock
rödbrun = brunröd
roddsport = sportrodd
roderstäv = stävroder
rödglöd = glödröd
rödgul = gulröd
rödljus = ljusröd
rödockra = ockraröd
rödräv = rävröd
rödvin = vinröd
rökoffer = offerrök
röntgenkontrast = kontraströntgen
röransats = ansatsrör
röraxel = axelrör
rördetektor = detektorrör
rördubb = dubbrör
röreffekt = effektrör
rörelsekapital = kapitalrörelse
rörelselängd = längdrörelse
rörelseskruv = skruvrörelse
rörfläns = flänsrör
rörförbindelse = förbindelserör
rörindustri = industrirör
rörjärn = järnrör
rörkabel = kabelrör
rörkondensator = kondensatorrör
rörmodulator = modulatorrör
rörmuff = muffrör
röroscillator = oscillatorrör
rörram = ramrör
rörskarv = skarvrör
rörsocker = sockerrör
rörspiral = spiralrör
rörtegel = tegelrör
rörtenn = tennrör
rörtork = torkrör
rörtransport = transportrör
rörventil = ventilrör
rörvinkel = vinkelrör
röstande = anderöst
rostbrun = brunrost
rostjärn = järnrost
rostring = ringrost
rosttork = torkrost
rotationsaxel = axelrotations
rotblad = bladrot
rotdjup = djuprot
rothål = hålrot
rotknöl = knölrot
rotselleri = sellerirot
rotträd = trädrot
rundradiosatellit = satellitrundradio
rusket = etrusk
ryggås = åsrygg
ryggsåg = sågrygg
sabra = brasa
säckcement = cementsäck
säckfilter = filtersäck
såddfläck = fläcksådd
såddmaskin = maskinsådd
såddrad = radsådd
sadelbom = bomsadel
saga = gasa
sagas = gassa
sågblock = blocksåg
sågbord = bordsåg
sågbygel = bygelsåg
sågdrag = dragsåg
sågkam = kamsåg
sågmaskin = maskinsåg
sago = gosa
sågram = ramsåg
sågrygg = ryggsåg
sågspån = spånsåg
sågspår = spårsåg
sågstock = stocksåg
sågsträng = strängsåg
sågtimmer = timmersåg
sågträ = träsåg
såja = jaså
saken = ensak
sakvärde = värdesak
salas = lassa
sälpäls = pälssäl
saltbad = badsalt
saltsten = stensalt
salu = lusa
salutkanon = kanonsalut
såmaskin = maskinså
samen = ensam
samföretag = företagsam
samhushåll = hushållsam
samordning = ordningsam
samspråk = språksam
sandbädd = bäddsand
sandbläster = blästersand
sanddyn = dynsand
sandfilter = filtersand
sandform = formsand
sandgjuteri = gjuterisand
sandöken = ökensand
sandsten = stensand
sandstrand = strandsand
sandströ = strösand
sångfågel = fågelsång
sångkör = körsång
sångsolo = solosång
sångtrast = trastsång
sårad = radså
satellitrundradio = rundradiosatellit
satinfoder = fodersatin
satsadverbial = adverbialsats
satsblock = blocksats
satsformat = formatsats
satsfräs = frässats
satshjul = hjulsats
satskoks = kokssats
sätter = ersätt
sättvagn = vagnsätt
savas = vassa
saxbult = bultsax
saxnäbb = näbbsax
schabervals = valsschaber
schablonfräs = frässchablon
schablonsvarv = svarvschablon
sebu = buse
sedan = danse
segelbåt = båtsegel
segelled = ledsegel
segelrå = råsegel
segerval = valseger
segregerade = desegregera
sektorfyr = fyrsektor
selar = arsel
sellerirot = rotselleri
selleristjälk = stjälkselleri
senar = arsen
sensibiliserade = desensibilisera
seriemotor = motorserie
serienummer = nummerserie
serin = inser
serva = vaser
servicebil = bilservice
serviceväg = vägservice
servisglas = glasservis
servobroms = bromsservo
setjumper = jumperset
sidenatlas = atlassiden
sidenbrokad = brokadsiden
sidfot = fotsid
signade = designa
signalbild = bildsignal
signalbrytrelä = brytreläsignal
signaleld = eldsignal
signalfärg = färgsignal
signalfel = felsignal
signalhorn = hornsignal
signalhuvud = huvudsignal
signalkod = kodsignal
signalljud = ljudsignal
signalljus = ljussignal
signalraket = raketsignal
signaltecken = teckensignal
signaltelefon = telefonsignal
signalton = tonsignal
signerade = designera
siktbotten = bottensikt
siktmjöl = mjölsikt
silbotten = bottensil
silkar = karsil
silofoder = fodersilo
silotorn = tornsilo
silverblad = bladsilver
silverblank = blanksilver
silvermynt = myntsilver
silvertråd = trådsilver
sinande = andesin
sinar = arsin
sirenlarm = larmsiren
sirentjut = tjutsiren
sistas = assist
sjöberg = bergsjö
sjöfågel = fågelsjö
sjöstrand = strandsjö
sjövik = viksjö
sjukbil = bilsjuk
skadan = danska
skaftkniv = knivskaft
skaftkrok = krokskaft
skaftmejsel = mejselskaft
skaftskruv = skruvskaft
skägglös = lösskägg
skäggstubb = stubbskägg
skakar = karska
skala = laska
skållager = lagerskål
skalpotatis = potatisskal
skålvåg = vågskål
skänkkran = kranskänk
skänkpip = pipskänk
skänkvagn = vagnskänk
skåptork = torkskåp
skäraren = renskära
skärborr = borrskär
skärhuvud = huvudskär
skärinsats = insatsskär
skärmbild = bildskärm
skärstål = stålskär
skarva = vaskar
skarvband = bandskarv
skarvkabel = kabelskarv
skarvrör = rörskarv
skärvsten = stenskärv
skarvsvets = svetsskarv
skarvtråd = trådskarv
skata = taska
skava = vaska
skenbro = brosken
skeppslag = slagskepp
skiffergrön = grönskiffer
skifferkol = kolskiffer
skiffersvart = svartskiffer
skiffertak = takskiffer
skikten = enskikt
skiktkol = kolskikt
skiktplan = planskikt
skinnfoder = foderskinn
skjutshäst = hästskjuts
skobroms = bromssko
skogen = enskog
skogslag = slagskog
skojärn = järnsko
skoläder = lädersko
sköldlager = lagersköld
skörtrock = rockskört
skostift = stiftsko
skottårs = årsskott
skottbom = bomskott
skottdag = dagskott
skottstart = startskott
skotyg = tygsko
skovelhjul = hjulskovel
skovelpump = pumpskovel
skriftbild = bildskrift
skrifttecken = teckenskrift
skrivaren = renskriva
skrotbil = bilskrot
skrotgummi = gummiskrot
skrotjärn = järnskrot
skrotkoppar = kopparskrot
skrotmetall = metallskrot
skrotstål = stålskrot
skruvbänk = bänkskruv
skruvbroms = bromsskruv
skruvbult = bultskruv
skruvfjäder = fjäderskruv
skruvfräs = frässkruv
skruvhuvud = huvudskruv
skruvkontakt = kontaktskruv
skruvkork = korkskruv
skruvlås = låsskruv
skruvlock = lockskruv
skruvmaskin = maskinskruv
skruvmikrometer = mikrometerskruv
skruvrörelse = rörelseskruv
skruvskaft = skaftskruv
skruvspår = spårskruv
skruvstål = stålskruv
skruvstift = stiftskruv
skruvtving = tvingskruv
skuldkonto = kontoskuld
skvallerkäring = käringskvaller
skyddslag = slagskydd
skyltemalj = emaljskylt
sladderkäring = käringsladder
slagfält = fältslag
slagfärdig = färdigslag
slaggbly = blyslagg
slaggcement = cementslagg
slaggjärn = järnslagg
slaghål = hålslag
slagmotstånd = motståndslag
slagpendel = pendelslag
slagskepp = skeppslag
slagskog = skogslag
slagskydd = skyddslag
slagträ = träslag
slagvatten = vattenslag
slambotten = bottenslam
slamkalk = kalkslam
slamkol = kolslam
slangfilter = filterslang
slangventil = ventilslang
slevprov = provslev
slidlås = låsslid
slidplan = planslid
sligen = enslig
sliparen = renslipa
slipspår = spårslip
slipsten = stenslip
slipventil = ventilslip
slipvinkel = vinkelslip
slogan = anslog
slusshamn = hamnsluss
slusskanal = kanalsluss
slutet = etslut
slutför = förslut
slutrad = radslut
smaklök = löksmak
smidestång = stångsmide
smilare = resmila
smörexport = exportsmör
smörmejeri = mejerismör
snabbstart = startsnabb
snökorn = kornsnö
snölös = lössnö
sockelsten = stensockel
sockelstift = stiftsockel
sockerbit = bitsocker
sockerlönn = lönnsocker
sockerrör = rörsocker
sockerströ = strösocker
sockertopp = toppsocker
sodatvätt = tvättsoda
solosång = sångsolo
soloviolin = violinsolo
solvtråd = trådsolv
sömhål = hålsöm
sömkil = kilsöm
sömmaskin = maskinsöm
sömstick = sticksöm
sömsvets = svetssöm
sondotter = dotterson
sortförsök = försöksort
sotas = tasso
sotfläck = fläcksot
sötsur = sursöt
spackelfärg = färgspackel
spakbroms = bromsspak
spakspel = spelspak
spånhyvel = hyvelspån
spånkorg = korgspån
spannhäst = hästspann
spånsåg = sågspån
spåntak = takspån
spantjärn = järnspant
spantvinkel = vinkelspant
spåraxel = axelspår
spårbroms = bromsspår
spårförbindelse = förbindelsespår
spårkil = kilspår
spårlager = lagerspår
spårlängd = längdspår
spårmagnet = magnetspår
spårmejsel = mejselspår
spårmönster = mönsterspår
spärraxel = axelspärr
spärrballong = ballongspärr
spärrband = bandspärr
spärrbroms = bromsspärr
spärrgaller = gallerspärr
spårring = ringspår
spårsåg = sågspår
spårskruv = skruvspår
spårslip = slipspår
spårvagns = vagnsspår
spårväg = vägspår
spårvals = valsspår
spårväxel = växelspår
spegeldörr = dörrspegel
spegellampett = lampettspegel
spegelplan = planspegel
spegelreflektor = reflektorspegel
spegelteleskop = teleskopspegel
spegelvägg = väggspegel
spegelvalv = valvspegel
spelautomat = automatspel
spelaxel = axelspel
spelbåt = båtspel
speldator = datorspel
spelglad = gladspel
spelkort = kortspel
spelnock = nockspel
spelspak = spakspel
spetsborr = borrspets
spetselektrod = elektrodspets
spetsgavel = gavelspets
spetshorn = hornspets
spetskontakt = kontaktspets
spetslager = lagerspets
spetsnål = nålspets
spetspunktur = punkturspets
spetsstål = stålspets
spetstand = tandspets
spetsvals = valsspets
spetsvinkel = vinkelspets
spettgrill = grillspett
spikjärn = järnspik
spiktråd = trådspik
spillvärme = värmespill
spindelborr = borrspindel
spindelhuvud = huvudspindel
spinnerimaskin = maskinspinneri
spiralborr = borrspiral
spiralfjäder = fjäderspiral
spiralrör = rörspiral
spiraltråd = trådspiral
spisel = elspis
spisved = vedspis
spjutkast = kastspjut
splitterbomb = bombsplitter
spontstål = stålspont
sportbil = bilsport
sportflyg = flygsport
sportrodd = roddsport
språkform = formspråk
språkkod = kodspråk
språksam = samspråk
språksymbol = symbolspråk
språnglinje = linjesprång
sprintaxel = axelsprint
sprintbult = bultsprint
spritmotor = motorsprit
spröjsbly = blyspröjs
stabiliserade = destabilisera
stadband = bandstad
städhorn = hornstäd
stadsbo = bostads
staga = gasta
stagfock = fockstag
stagtråd = trådstag
stålaxel = axelstål
stålband = bandstål
stålborr = borrstål
stålbult = bultstål
stålcement = cementstål
stålfil = filstål
stålfjäder = fjäderstål
stålgöt = götstål
stålhärd = härdstål
stålkant = kantstål
stålkätting = kättingstål
stålkil = kilstål
stålkonverter = konverterstål
ställmotor = motorställ
ställverk = verkställ
stålnit = nitstål
stålprofil = profilstål
stålskär = skärstål
stålskrot = skrotstål
stålskruv = skruvstål
stålspets = spetsstål
stålspont = spontstål
stålstång = stångstål
stålstick = stickstål
stålsvarv = svarvstål
ståltryck = tryckstål
stålvals = valsstål
stålvinkel = vinkelstål
stamdjur = djurstam
stamknöl = knölstam
stampbetong = betongstamp
stämpeldatum = datumstämpel
stämpelgummi = gummistämpel
stämpeljärn = järnstämpel
stämpelkort = kortstämpel
stamphål = hålstamp
stamträd = trädstam
standardmängd = mängdstandard
standardpris = prisstandard
standardprodukt = produktstandard
stångbetsel = betselstång
stångbroms = bromsstång
stångjärn = järnstång
stångkoppar = kopparstång
stångkoppel = koppelstång
stånglack = lackstång
stångmagnet = magnetstång
stängselnät = nätstängsel
stängseltråd = trådstängsel
stångsmide = smidestång
stångstål = stålstång
stänkvatten = vattenstänk
stansform = formstans
stansgravör = gravörstans
stansverk = verkstans
stare = resta
starktryck = tryckstark
startbil = bilstart
startmotor = motorstart
startprogram = programstart
startskott = skottstart
startsnabb = snabbstart
stativkabel = kabelstativ
stativkamera = kamerastativ
statsfru = frustats
staty = tysta
stavantenn = antennstav
stavhopp = hoppstav
stavmagnet = magnetstav
stavmått = måttstav
stavparkett = parkettstav
stavreflektor = reflektorstav
stävroder = roderstäv
stävtak = takstäv
stegbredd = breddsteg
stegkil = kilsteg
stegplan = plansteg
stegraket = raketsteg
stekbiff = biffstek
stekfläsk = fläskstek
stenbädd = bäddsten
stenbotten = bottensten
stenfri = fristen
stengolv = golvsten
stengrund = grundsten
stenkaj = kajsten
stenkant = kantsten
stenkil = kilsten
stenkvarn = kvarnsten
stenlås = låssten
stenmosaik = mosaiksten
stenmur = mursten
stenografimaskin = maskinstenografi
stensalt = saltsten
stensand = sandsten
stenskärv = skärvsten
stenslip = slipsten
stensockel = sockelsten
stentuff = tuffsten
stenvalv = valvsten
stickkniv = knivstick
sticknål = nålstick
sticksöm = sömstick
stickstål = stålstick
stiftsko = skostift
stiftskruv = skruvstift
stiftsockel = sockelstift
stifttråd = trådstift
stilmöbel = möbelstil
stimfisk = fiskstim
stjälkselleri = selleristjälk
stockbro = brostock
stockmått = måttstock
stocksåg = sågstock
stockträd = trädstock
stödarm = armstöd
stödaxel = axelstöd
stödfot = fotstöd
stödparti = partistöd
stödsystem = systemstöd
stödvägg = väggstöd
stödvals = valsstöd
stödvinkel = vinkelstöd
stolborr = borrstol
stolgång = gångstol
stolkarm = karmstol
stollift = liftstol
stoppbom = bomstopp
stoppfjäder = fjäderstopp
stoppventil = ventilstopp
storman = anstorm
stormeld = eldstorm
stöthorn = hornstöt
stötström = strömstöt
stöttryck = tryckstöt
stötvåg = vågstöt
sträckfågel = fågelsträck
strandbad = badstrand
strandsand = sandstrand
strandsjö = sjöstrand
strängsåg = sågsträng
streckmått = måttstreck
strömback = backström
strömfas = fasström
strömfel = felström
strömimpuls = impulsström
strömkors = korsström
strömlinje = linjeström
strömmas = masström
strömstöt = stötström
strömtransformator = transformatorström
strömvåg = vågström
strömvärme = värmeström
strömvirvel = virvelström
strösand = sandströ
strösocker = sockerströ
strötorv = torvströ
stubbåker = åkerstubb
stubbskägg = skäggstubb
stybbkol = kolstybb
styckekol = kolstycke
stycketorv = torvstycke
styckeverk = verkstycke
succéfilm = filmsuccé
sugluft = luftsug
sugvatten = vattensug
sulfurerade = desulfurera
summarisk = risksumma
supportsvarv = svarvsupport
surrogatkaffe = kaffesurrogat
sursöt = sötsur
svallvåg = vågsvall
svampgummi = gummisvamp
svamphatt = hattsvamp
svampplast = plastsvamp
svängbar = barsväng
svängborr = borrsväng
svängningsaxel = axelsvängnings
svängplog = plogsväng
svartblå = blåsvart
svartgrå = gråsvart
svartskiffer = skiffersvart
svarvautomat = automatsvarv
svarvbänk = bänksvarv
svarvchuck = chucksvarv
svarvdiamant = diamantsvarv
svarvdubb = dubbsvarv
svarvfaner = fanersvarv
svarvhjul = hjulsvarv
svarvjärn = järnsvarv
svarvprisma = prismasvarv
svarvschablon = schablonsvarv
svarvstål = stålsvarv
svarvsupport = supportsvarv
svetsfog = fogsvets
svetskraft = kraftsvets
svetsplan = plansvets
svetspunkt = punktsvets
svetsrand = randsvets
svetsskarv = skarvsvets
svetssöm = sömsvets
svetstråd = trådsvets
svetstryck = trycksvets
svettull = ullsvett
symbolspråk = språksymbol
synfel = felsyn
syngräns = gränssyn
synkpuls = pulssynk
syraester = estersyra
syraharts = hartssyra
syratorn = tornsyra
syraväte = vätesyra
systemimpedans = impedanssystem
systemkontroll = kontrollsystem
systemlinje = linjesystem
systemstöd = stödsystem
tablås = blåsta
tadel = delta
taga = gata
tågan = antåg
tagande = andetag
tagas = gasta
tagen = genta
taggas = gastag
tågpolygon = polygontåg
takantenn = antenntak
takås = åstak
takbalk = balktak
takfilt = filttak
takglas = glastak
takhalm = halmtak
takkupol = kupoltak
taklös = klösta
takort = orttak
takpanel = paneltak
takpapp = papptak
takplåt = plåttak
takskiffer = skiffertak
takspån = spåntak
takstäv = stävtak
taktegel = tegeltak
takterrass = terrasstak
täktmark = marktäkt
takvalv = valvtak
tala = lata
talan = antal
talangen = gentalan
talas = lasta
talat = latta
talen = ental
talför = förtal
talförhållande = förhållandetal
tallinje = linjetal
tallmyr = myrtall
talltimmer = timmertall
talman = mantal
talrikt = rikttal
talus = lusta
talvärde = värdetal
tandfräs = frästand
tandguld = guldtand
tandhyvel = hyveltand
tandrasp = rasptand
tandspets = spetstand
tanga = gatan
tångled = ledtång
tånglim = limtång
tankar = kartan
tanten = tentan
tapetväv = vävtapet
tappaxel = axeltapp
tappborr = borrtapp
tappcentrum = centrumtapp
tappfog = fogtapp
tappkran = krantapp
tapplager = lagertapp
tapptryck = trycktapp
tariffpremie = premietariff
taska = skata
tasso = sotas
taxiflyg = flygtaxi
teaterfolk = folkteater
teatergrupp = gruppteater
teaterturné = turnéteater
tebe = bete
teckengrad = gradtecken
teckensignal = signaltecken
teckenskrift = skrifttecken
tegelbetong = betongtegel
tegelfasad = fasadtegel
tegelform = formtegel
tegelgolv = golvtegel
tegelmur = murtegel
tegelpress = presstegel
tegelrör = rörtegel
tegeltak = taktegel
tegelvalv = valvtegel
tein = inte
teju = jute
telefonautomat = automattelefon
telefonkort = korttelefon
telefonsignal = signaltelefon
telegramkod = kodtelegram
telen = lente
teleskopspegel = spegelteleskop
tellurvismut = vismuttellur
temat = matte
tenar = arten
tennisproffs = proffstennis
tennrör = rörtenn
tenor = orten
tentan = tanten
terapigrupp = gruppterapi
terapin = pintera
termos = moster
terpentinbalsam = balsamterpentin
terpin = pinter
terrasstak = takterrass
tesla = lates
tetraetylbly = blytetraetyl
tetrametylbly = blytetrametyl
teve = vete
textannons = annonstext
textreklam = reklamtext
textur = urtext
tidimpuls = impulstid
tidkontakt = kontakttid
tidnormal = normaltid
tidsmål = måltids
tidur = urtid
tidzon = zontid
tillsatsbatteri = batteritillsats
tillväxtmedel = medeltillväxt
timmerhus = hustimmer
timmersåg = sågtimmer
timmertall = talltimmer
timmervägg = väggtimmer
tippvagn = vagntipp
tjutsiren = sirentjut
togan = antog
toleransfel = feltolerans
tonar = arton
tonåringar = artonåring
tonfärg = färgton
tonhuvud = huvudton
tonregister = registerton
tonsignal = signalton
toppcylinder = cylindertopp
toppfilt = filttopp
toppform = formtopp
toppnät = nättopp
toppsocker = sockertopp
topptrafik = trafiktopp
torkband = bandtork
torkcentrifug = centrifugtork
torkcylinder = cylindertork
torketage = etagetork
torkfläkt = fläkttork
torkkanal = kanaltork
torkluft = lufttork
torkpress = presstork
torkrör = rörtork
torkrost = rosttork
torkskåp = skåptork
torktorn = torntork
torktunnel = tunneltork
torkvals = valstork
tornkanon = kanontorn
tornsilo = silotorn
tornsyra = syratorn
torntork = torktorn
torvbotten = bottentorv
torvdy = dytorv
torvfiber = fibertorv
torvfräs = frästorv
torvmaskin = maskintorv
torvmyr = myrtorv
torvpress = presstorv
torvströ = strötorv
torvstycke = stycketorv
träasbest = asbestträ
trädan = anträd
trådantenn = antenntråd
trådbroms = bromstråd
trådeker = ekertråd
trådglas = glastråd
trädgräns = gränsträd
trådguld = guldtråd
trådjärn = järntråd
trådkant = kanttråd
trådlack = lacktråd
trådmantel = manteltråd
trådprov = provtråd
trädrot = rotträd
trådsilver = silvertråd
trådskarv = skarvtråd
trådsolv = solvtråd
trådspik = spiktråd
trådspiral = spiraltråd
trådstag = stagtråd
trädstam = stamträd
trådstängsel = stängseltråd
trådstift = stifttråd
trädstock = stockträd
trådsvets = svetstråd
trådvals = valstråd
träfärg = färgträ
trafikbil = biltrafik
trafikcentrum = centrumtrafik
trafikflyg = flygtrafik
trafikflygplats = flygplatstrafik
trafikförbindelse = förbindelsetrafik
trafikkanal = kanaltrafik
trafiklast = lasttrafik
trafiklinje = linjetrafik
trafikpost = posttrafik
trafiktopp = topptrafik
trafikväg = vägtrafik
traktorband = bandtraktor
traktormotor = motortraktor
trälamell = lamellträ
trälim = limträ
trälist = listträ
trängtans = ansträngt
transformatoreffekt = effekttransformator
transformatorström = strömtransformator
transportband = bandtransport
transportbil = biltransport
transportfläkt = fläkttransport
transportflyg = flygtransport
transportgods = godstransport
transportmaterial = materialtransport
transportörband = bandtransportör
transportort = orttransport
transportrör = rörtransport
transportväg = vägtransport
träram = ramträ
träsåg = sågträ
träslag = slagträ
trastsång = sångtrast
trattfals = falstratt
trattkvarn = kvarntratt
tröskelenergi = energitröskel
trosskompani = kompanitross
truckgaffel = gaffeltruck
truckkran = krantruck
tryckaxel = axeltryck
tryckborr = borrtryck
tryckdifferens = differenstryck
tryckdrag = dragtryck
tryckfärg = färgtryck
tryckfel = feltryck
tryckfjäder = fjädertryck
tryckgas = gastryck
tryckgrundvatten = grundvattentryck
tryckkabin = kabintryck
tryckkattun = kattuntryck
tryckkolv = kolvtryck
tryckkondensator = kondensatortryck
tryckkontakt = kontakttryck
trycklager = lagertryck
trycklinje = linjetryck
tryckluft = lufttryck
tryckmaskin = maskintryck
tryckpress = presstryck
tryckpropeller = propellertryck
tryckprov = provtryck
tryckreservoar = reservoartryck
tryckring = ringtryck
tryckstål = ståltryck
tryckstark = starktryck
tryckstöt = stöttryck
trycksvets = svetstryck
trycktapp = tapptryck
trycktyp = typtryck
tryckvals = valstryck
tryckvalv = valvtryck
tryckvatten = vattentryck
tryckverk = verktryck
tuban = bantu
tubas = bastu
tubfärg = färgtub
tuffsten = stentuff
tullgräns = gränstull
tullväg = vägtull
tullvärde = värdetull
tunnelaxel = axeltunnel
tunnelgång = gångtunnel
tunneltork = torktunnel
turbåt = båttur
turbinpropeller = propellerturbin
turbuss = busstur
turliga = ligatur
turnéteater = teaterturné
tvättautomat = automattvätt
tvättfilter = filtertvätt
tvättmaskin = maskintvätt
tvättsoda = sodatvätt
tvättvals = valstvätt
tvillingkristall = kristalltvilling
tvingskruv = skruvtving
tygfilter = filtertyg
tygfoder = fodertyg
tygsko = skotyg
tyllgardin = gardintyll
typfel = feltyp
typhuvud = huvudtyp
typmaskin = maskintyp
typmetall = metalltyp
typtryck = trycktyp
tysta = staty
ugnsgas = gasugns
ullfår = fårull
ullfett = fettull
ullhår = hårull
ullkam = kamull
ullsvett = svettull
urtext = textur
urtid = tidur
utanför = förutan
utför = förut
utnyttjandealternativ = alternativutnyttjande
våganalys = analysvåg
vägasfalt = asfaltväg
vågband = bandvåg
vägdamm = dammväg
vägförbindelse = förbindelseväg
väggen = genväg
väggpanel = panelvägg
väggputs = putsvägg
väggrus = grusväg
väggspegel = spegelvägg
väggstöd = stödvägg
väggtimmer = timmervägg
vägkors = korsväg
vägmakadam = makadamväg
vågmeter = metervåg
vagnborr = borrvagn
vagnbroms = bromsvagn
vagnfjäder = fjädervagn
vagnflak = flakvagn
vagnhiss = hissvagn
vagnhus = husvagn
vagnkorg = korgvagn
vagnlast = lastvagn
vagnretort = retortvagn
vagnsätt = sättvagn
vagnshus = husvagns
vagnskänk = skänkvagn
vagnsspår = spårvagns
vagntipp = tippvagn
vagnvåg = vågvagn
vågplan = planvåg
vägring = ringväg
vägservice = serviceväg
vågskål = skålvåg
vägspår = spårväg
vågstöt = stötvåg
vågström = strömvåg
vågsvall = svallvåg
vägtrafik = trafikväg
vägtransport = transportväg
vägtull = tullväg
vågvagn = vagnvåg
vaja = java
vakar = karva
vaknatt = nattvak
vakthund = hundvakt
vala = lava
valar = larva
vale = leva
valin = inval
vallokal = lokalval
valseger = segerval
valsform = formvals
valsfräs = fräsvals
valsglas = glasvals
valsgummi = gummivals
valskalander = kalandervals
valskant = kantvals
valskontroller = kontrollervals
valskross = krossvals
valsläder = lädervals
valsmassa = massavals
valspress = pressvals
valsschaber = schabervals
valsspår = spårvals
valsspets = spetsvals
valsstål = stålvals
valsstöd = stödvals
valstork = torkvals
valstråd = trådvals
valstryck = tryckvals
valstvätt = tvättvals
valsvält = vältvals
vältring = ringvält
vältvals = valsvält
valutaclearing = clearingvaluta
valutakorg = korgvaluta
valutakredit = kreditvaluta
valvbro = brovalv
valvdörr = dörrvalv
valvform = formvalv
valvfot = fotvalv
valvport = portvalv
valvring = ringvalv
valvspegel = spegelvalv
valvsten = stenvalv
valvtak = takvalv
valvtegel = tegelvalv
valvtryck = tryckvalv
väntan = använt
varans = ansvar
vårddag = dagvård
värdeanalys = analysvärde
värden = envärd
värdesak = sakvärde
värdetal = talvärde
värdetull = tullvärde
vårdhem = hemvård
vårdpersonal = personalvård
värdprogram = programvärd
vare = reva
varför = förvar
vargens = gensvar
värmecentral = centralvärme
värmeförlust = förlustvärme
värmeljus = ljusvärme
värmerekord = rekordvärme
värmespill = spillvärme
värmeström = strömvärme
varnare = revarna
varor = orvar
varpå = påvar
varskor = korvars
varsla = lavars
vaser = serva
vaskar = karvas
vaskar = skarva
vaska = skava
vassa = savas
vassleost = ostvassle
vätesyra = syraväte
vattenbad = badvatten
vattenbarlast = barlastvatten
vattenblank = blankvatten
vattendjup = djupvatten
vattendrift = driftvatten
vattenfall = fallvatten
vattenfilm = filmvatten
vattenfläck = fläckvatten
vattengas = gasvatten
vattenkalk = kalkvatten
vattenklar = klarvatten
vattenklosett = klosettvatten
vattenkran = kranvatten
vattenkvarn = kvarnvatten
vattenled = ledvatten
vattenlednings = ledningsvatten
vattenpöl = pölvatten
vattenslag = slagvatten
vattenstänk = stänkvatten
vattensug = sugvatten
vattentryck = tryckvatten
vävplast = plastväv
vävtapet = tapetväv
växeldriv = drivväxel
växelfält = fältväxel
växelhjul = hjulväxel
växelnät = nätväxel
växelomsättnings = omsättningsväxel
växelspår = spårväxel
vaxkitt = kittvax
växtfärg = färgväxt
växtfiber = fiberväxt
vedcellulosa = cellulosaved
veden = enved
vedfamn = famnved
vedkap = kapved
vedkast = kastved
vedklabb = klabbved
vedklamp = klampved
vedklyv = klyvved
vedkubb = kubbved
vedmassa = massaved
vedspis = spisved
vektorfält = fältvektor
vela = lave
ventilfjäder = fjäderventil
ventilklaff = klaffventil
ventilkolv = kolvventil
ventillyft = lyftventil
ventilnål = nålventil
ventilrör = rörventil
ventilslang = slangventil
ventilslip = slipventil
ventilstopp = stoppventil
verkjärn = järnverk
verkställ = ställverk
verkstans = stansverk
verkstycke = styckeverk
verktryck = tryckverk
versal = alvers
verserad = adverser
vete = teve
vevborr = borrvev
vevinduktor = induktorvev
vibrationsaxel = axelvibrations
videokassett = kassettvideo
viksjö = sjövik
viktlast = lastvikt
viktlös = lösvikt
viktregulator = regulatorvikt
vindkast = kastvind
vindkvarn = kvarnvind
vinkaraff = karaffvin
vinkelaxel = axelvinkel
vinkelband = bandvinkel
vinkelborr = borrvinkel
vinkelfog = fogvinkel
vinkeljärn = järnvinkel
vinkel = kelvin
vinkelknä = knävinkel
vinkelkontakt = kontaktvinkel
vinkelpress = pressvinkel
vinkelprofil = profilvinkel
vinkelrör = rörvinkel
vinkelslip = slipvinkel
vinkelspant = spantvinkel
vinkelspets = spetsvinkel
vinkelstål = stålvinkel
vinkelstöd = stödvinkel
vinröd = rödvin
vinschnock = nockvinsch
vinstmarginal = marginalvinst
violinsolo = soloviolin
virabrons = bronsvira
virvelström = strömvirvel
visen = envis
visheten = envishet
vismuttellur = tellurvismut
vispar = parvis
vitglöd = glödvit
vitgrå = gråvit
vitgul = gulvit
vitsord = ordvits
vulstring = ringvulst
ylar = aryl
ylas = asyl
ylet = etyl
ylleflock = flockylle
zongräns = gränszon
zontid = tidzon
